###############
#             S
##### #########
###    ########
#####E#########